{
  "MapTexture": "7in3vdy789jgiu37qyhf939j",
  "Tiles": [
    339,172,361,172,361,362,361,172,361,172,361,362,361,172,361,362,
    185,360,381,360,381,382,381,360,381,360,381,382,195,196,381,158,
    363,364,123,124,365,366,365,364,131,128,365,366,131,128,365,138,
    383,384,143,144,385,386,385,384,195,196,385,386,195,196,381,158,
    339,340,131,128,361,362,361,340,131,128,361,340,131,128,365,138,
    359,360,195,196,381,382,195,360,195,196,195,360,195,196,381,158,
    165,364,125,126,365,366,131,128,125,126,125,126,125,126,365,138,
    359,360,145,146,381,382,195,196,145,146,145,146,145,146,381,158,
    165,364,131,128,365,366,365,364,365,364,365,364,131,128,365,138,
    359,360,195,196,381,382,385,384,385,384,385,384,195,196,385,386,
    165,364,131,128,365,366,339,340,361,340,361,340,131,128,361,362,
    359,360,195,196,381,382,359,360,195,196,195,196,195,196,381,158,
    165,364,125,126,131,128,131,128,131,128,131,128,125,126,365,138,
    359,360,145,146,195,196,195,196,195,196,195,196,145,146,381,158,
    165,364,365,364,365,366,365,364,365,364,365,364,365,364,365,138,
    383,384,385,384,385,386,385,384,385,384,385,384,385,384,385,386
  ]
}