{
  "MapTexture": "7in3vdy789jgiu37qyhf939j",
  "Tiles": [
    53,54,53,54,53,54,53,54,53,54,53,54,53,54,53,54,
    73,74,73,74,73,74,73,74,73,74,73,74,73,74,73,74,
    101,102,101,102,101,102,101,102,101,102,101,102,101,102,101,102,
    222,222,222,222,222,222,222,222,222,222,222,222,222,222,222,222,
    224,224,224,224,224,224,224,224,224,224,224,224,224,224,224,224,
    214,214,214,214,213,218,214,214,214,214,214,214,214,214,214,214,
    85,86,85,86,233,238,85,86,85,86,85,86,85,86,85,86,
    105,106,105,106,343,330,105,106,105,106,105,106,105,106,105,106,
    234,301,301,237,343,330,41,43,48,234,301,237,41,47,47,48,
    306,242,242,283,343,330,43,43,42,278,242,275,42,42,42,42,
    246,247,258,283,343,330,234,309,309,302,242,279,309,309,309,237,
    41,48,306,283,61,68,278,242,255,256,256,256,256,256,258,243,
    61,68,306,283,43,43,278,242,275,41,48,41,47,48,306,243,
    42,42,278,279,309,309,302,242,275,343,346,44,44,47,306,243,
    234,309,302,242,242,242,242,242,275,343,346,234,309,309,302,243,
    246,287,287,287,287,287,287,287,249,61,68,246,287,287,287,249
  ]
}