{
  "MapTexture": "7in3vdy789jgiu37qyhf939j",
  "Tiles": [
    41,42,42,42,42,48,42,42,42,42,42,42,42,42,42,48,
    245,234,236,236,237,244,234,236,236,236,236,236,236,236,237,244,
    245,282,261,261,283,244,282,261,261,261,261,261,261,261,283,244,
    245,282,261,261,283,244,282,261,261,261,261,261,261,261,283,244,
    245,282,261,261,283,244,282,261,261,255,256,258,261,261,283,244,
    245,282,261,261,283,244,282,261,261,263,245,282,261,261,283,244,
    245,282,261,261,283,244,282,261,261,263,245,282,261,261,283,244,
    245,282,261,261,283,244,282,261,261,263,245,282,261,261,283,244,
    245,282,261,261,283,244,282,261,261,263,245,282,261,261,283,244,
    245,282,261,261,283,244,282,261,261,263,245,282,261,261,283,244,
    245,282,261,261,283,244,282,261,261,263,245,282,261,261,283,244,
    245,282,261,261,279,236,302,261,261,263,245,282,261,261,283,244,
    245,282,261,261,261,261,261,261,261,263,245,282,261,261,283,244,
    245,282,261,261,261,261,261,261,261,263,245,282,261,261,283,244,
    245,246,256,251,251,251,251,251,251,249,245,246,251,251,249,244,
    61,62,62,62,62,62,62,62,62,62,61,62,62,62,62,68
  ]
}
