{
  "MapTexture": "7in3vdy789jgiu37qyhf939j",
  "Tiles": [
    41,45,45,45,45,45,218,214,214,45,45,45,45,45,45,48,233,234,309,309,
    309,237,238,234,235,235,309,309,309,309,237,298,233,282,242,242,242,275,238,278,242,242,242,242,242,242,263,298,
    233,282,242,242,242,275,238,278,242,242,242,242,242,242,263,298,233,282,242,242,242,275,238,
    278,242,255,256,258,242,242,263,298,233,282,242,242,242,275,238,278,242,275,250,
    278,242,242,263,298,233,282,242,242,242,275,238,278,242,275,250,278,242,242,263,
    298,233,282,242,242,242,275,238,278,242,275,250,278,242,242,263,298,233,282,242,242,242,275,238,278,242,275,
    250,278,242,242,263,298,233,282,242,242,242,275,238,278,242,275,250,278,242,242,263,298,233,282,242,242,242,
    275,238,278,242,275,250,278,242,242,263,298,233,282,242,242,242,279,236,302,242,275,250,278,242,242,
    263,298,233,282,242,242,242,242,242,242,242,275,250,278,242,242,263,298,233,282,242,242,242,242,242,242,242,275,250,278,242,
    242,263,298,233,246,247,247,247,247,247,247,247,249,250,246,247,247,249,298,61,66,66,66,66,66,66,66,66,66,68,66,66,66,66,68
  ]
}
